{
  "layout": [
    [0, 1, 1, 0, 0, 0, 0, 0, 0, 0],
    [0, 1, 1, 1, 0, 0, 0, 0, 0, 0],
    [0, 0, 2, 2, 2, 0, 0, 0, 0, 0],
    [0, 0, 2, 3, 2, 0, 0, 0, 0, 0],
    [0, 0, 0, 3, 3, 3, 0, 0, 0, 0],
    [0, 0, 0, 0, 3, 3, 3, 0, 0, 0],
    [0, 0, 0, 0, 0, 0, 0, 0, 0, 0],
    [0, 0, 0, 0, 0, 0, 0, 0, 0, 0],
    [0, 0, 0, 0, 0, 0, 0, 0, 0, 0],
    [0, 0, 0, 0, 0, 0, 0, 0, 0, 0]
  ],
  "zones": {
    "1": { "id": "chalet", "name": "Chalet du Fjord", "color": "#f59e0b" },
    "2": { "id": "quartier", "name": "Quartier du dépanneur", "color": "#38bdf8" },
    "3": { "id": "centreville", "name": "Centre-ville & Bar La Pogne", "color": "#f472b6" }
  }
}
