{
  "layout":[
    [0,0,1,1,0,0,0,0,0,0],
    [0,0,1,1,0,0,0,0,0,0],
    [0,0,0,2,0,0,0,0,0,0],
    [0,0,0,2,0,0,0,0,0,0],
    [0,0,0,2,2,2,3,3,0,0],
    [0,0,0,0,0,0,3,3,0,0],
    [0,0,0,0,0,0,0,0,0,0],
    [0,0,0,0,0,0,0,0,0,0],
    [0,0,0,0,0,0,0,0,0,0],
    [0,0,0,0,0,0,0,0,0,0]
  ],
  "zones":{"1":{"id":"chalet","name":"Chalet","color":"#6366f1"},"2":{"id":"sentier","name":"Sentier","color":"#84cc16"},"3":{"id":"quai","name":"Quai","color":"#06b6d4"}}
}